[Level] 
MapArr = [
[0, 0, 0, 0, 0, 12, 12, 0, 10, 0, 0, 0, 5], 
[0, 5, 0, 0, 10, 12, 12, 5, 0, 0, 0, 0, 0], 
[0, 11, 11, 0, 0, 5, 12, 11, 11, 0, 0, 5, 0], 
[0, 11, 11, 0, 0, 0, 0, 11, 11, 0, 10, 0, 0], 
[0, 0, 5, 0, 11, 11, 0, 0, 12, 12, 12, 5, 0], 
[0, 10, 12, 12, 11, 11, 0, 5, 12, 0, 0, 15, 1], 
[0, 0, 12, 12, 0, 10, 0, 0, 11, 11, 0, 2, 0], 
[0, 5, 12, 12, 12, 0, 0, 0, 11, 11, 0, 16, 3], 
[0, 0, 11, 11, 0, 0, 0, 0, 12, 12, 12, 0, 0], 
[0, 0, 11, 11, 0, 0, 10, 0, 12, 12, 12, 0, 5], 
[5, 0, 0, 5, 0, 0, 0, 0, 0, 11, 11, 0, 0], 
[0, 0, 10, 0, 0, 5, 0, 0, 5, 11, 11, 0, 0], 
[0, 0, 0, 0, 0, 0, 10, 0, 0, 0, 0, 0, 0]]