[Level] 
MapArr = [
[0, 12, 12, 12, 0, 0, 5, 0, 11, 12, 12, 12, 0], 
[0, 5, 12, 11, 5, 0, 5, 0, 11, 12, 12, 7, 0], 
[5, 5, 12, 11, 0, 5, 0, 0, 0, 0, 5, 5, 0], 
[0, 5, 0, 11, 0, 0, 5, 10, 11, 1, 0, 0, 0], 
[0, 0, 0, 11, 0, 0, 0, 0, 11, 0, 3, 3, 0], 
[5, 5, 4, 11, 0, 1, 1, 7, 11, 0, 0, 15, 1], 
[0, 0, 0, 11, 2, 5, 5, 0, 11, 2, 0, 2, 0], 
[2, 7, 5, 11, 2, 5, 5, 12, 11, 2, 1, 16, 3], 
[0, 0, 0, 11, 0, 4, 12, 12, 0, 0, 0, 0, 0], 
[5, 5, 4, 11, 0, 5, 5, 12, 11, 0, 7, 4, 2], 
[0, 3, 0, 11, 0, 4, 7, 12, 11, 0, 2, 0, 0], 
[0, 0, 1, 0, 0, 9, 7, 0, 11, 0, 5, 5, 4], 
[0, 0, 3, 11, 0, 9, 5, 0, 11, 0, 0, 0, 0]]

